8 8
1 1 1 1 1 1 1 1
1 1 1 1 1 1 1 1
1 1 1 1 1 1 1 1
1 1 1 1 1 1 1 1
1 1 1 1 1 1 1 1
1 1 1 1 1 1 1 1
1 1 1 1 1 1 1 1
2 2 2 2 2 2 2 2
2 2 2 2 2 2 2 2
-1 -1 -1 -1 -1 -1 -1 -1
3 3 3 3 3 3 3 3
5 5 5 5 5 5 5 5
9 9 9 9 9 9 9 9
6 6 6 6 6 6 6 6
0 0 0 0 0 0 0 0
0 0 0 0 0 0 0 0