5 5
2 1 1 1 2
1 1 1 1 1
1 1 1 1 1
1 1 1 1 1
2 1 1 1 2
0 -1 0 -1 0
5 0 5 0 5
0 -1 0 -1 0
5 0 5 0 5
0 -1 0 -1 0