10 10
1 1 1 1 1 1 1 1 1 1
1 1 1 1 1 1 1 1 1 1
1 1 1 1 1 1 1 1 1 1
1 1 1 1 1 1 1 1 1 1
1 1 1 1 1 1 1 1 1 1
1 1 1 1 1 1 1 1 1 1
1 1 1 1 1 1 1 1 1 1
1 1 1 1 1 2 2 1 1 1
1 1 1 1 1 2 2 1 1 1
1 1 1 1 1 1 1 1 1 1
0 0 0 0 0 0 0 0 0 0
0 0 -1 0 0 0 -1 0 -1 0
0 0 0 -1 -1 -1 0 -1 0 0
0 0 0 -1 5 3 5 0 -1 0
0 0 0 -1 3 5 3 -1 0 0
0 0 -1 0 5 3 5 -1 0 0
0 0 0 -1 0 -1 -1 -1 0 0
0 0 -1 0 -1 0 0 0 -1 0
0 0 0 0 0 0 0 0 0 0
0 0 0 0 0 0 0 0 0 0