20 10
1 1 1 1 1 1 1 1 1 1
1 2 2 2 1 1 1 1 1 1
1 2 2 2 1 1 1 1 1 1
1 2 2 2 1 1 1 1 1 1
1 1 1 1 1 1 1 1 1 1
1 1 1 1 1 1 1 1 1 1
1 1 1 1 1 1 1 1 1 1
1 1 1 1 1 1 2 2 1 1
1 1 1 1 1 1 2 2 1 1
1 1 1 1 1 1 1 1 1 1

0 -1 0 0 0 -1 0 0 -1 0
0 0 0 0 0 0 0 0 0 0
0 0 0 0 0 0 0 0 0 0
0 5 0 0 0 0 0 0 5 0
0 0 0 0 0 0 0 0 0 0
5 0 0 0 0 0 0 0 0 0
0 0 0 0 0 0 0 0 0 0
0 0 0 0 2 2 3 3 0 0
0 0 0 0 0 1 3 3 0 0
0 0 0 0 0 0 0 0 0 0